#######
###OO##
#OXXX##
#OXPXO#
##XXXO#
##OO###
#######
