           ############            ########
   #########          ##############      #
####         ######## #              #### #
#    #########      #   ##############  # #
# ####         #### ##                  # #
# #    #########  # ## ################ # #
# # #             # ## ################ # #
# # # ########## ## ## ###        ##### # #
# # # #P######## ##  #     ###### ##### # #
# # # #     X    ### #  #       # ##### # #
# # # # ########   # #### ####  #     # # #
# # # # #   O  # # #      #    ###### # # #
# # # # #      # # ######## #       # # # #
# # # # #      # #          # ####  # # # #
# # # # #      # ############  ### ## # # #
# # # # #      # ############# ###    # # #
# # # # #     ## ############# #    ### # #
# # # # #     #  ####  ######  #  # ### # #
# # # #       #        ##     ### # ### # #
# # # ###### ######### ##  #      # ### # #
# # #               ## ### # ###  # ### # ##
# # #  ####   ####  ##     #   #### ### #  #
#   ####  ######## ##   #  ###  #   ### ## #
##        ######## #  # ####### # #####  # #
 # ###### ##  #### # ##    #### #        # #
 # ##   #     ####   ##### ####    ####### #
 # ##      ## ##    ###### #  ####  ####   #
 # ##    # ## ##  # ###### #        #### ###
 # ####### ## ### #      # # ########  # #
 # #       ##     ###### # #           # #
 # # #######   #  ###### #    ######## # #
 # #         # ######### #### #        # #
 #    ########         #      # #####    #
 #  # ################ ######## ##### ####
 #### ################          ##### ##
    # ###############################  #
    #                                  #
    #  #################################
    ####
