  #####
###   #
# X # ##
# #  O #
#    # #
## #   #
 # P ###
 #####