################
#              #
# # ######     #
# #  X X X X#  #
# #   X X   ## ##
# # #X X X###OOO#
# #   X X  ##OOO#
# ###XXX X ##OOO#
#     # ## ##OOO#
#####   ## ##OOO#
    ##### P   ###
        #     #
        #######
