        #######
  #######  OOO#
  #       OOOO#
### # ### OOOO#
#   # ###OOOOO#
# ###   #OOOOO#
# #  X X#######
# # XXX   #   ###
# # X X X # P   ####
# # X XXX   # X    #
# #   X  ##### ### #
# ### # X#   X   # #
#   #    # X X X # #
### #### ## ### ## #
  #    # ##  ## #  #
  ####       ## # ##
     ###  ### X # #
       #### #  X  #
            #   ###
            #####
