###############
#  #     #O#  #
#  #     #    #
#  #     #    #
#  #  #  ###  #
#     #       #
#     #P      #
#  ############
#          #
##    ###X #
#     # #  #
####### ####