*XX**XXXX*******XXX****
*XX*X***XXX*XXX**XXXXX*
*XX*XXX**XX****X**XXXX*
*XX**XXX*XXXX*XXX**XXX*
*XXX***X*XXX**XX**XXX**
**XX*X***XXX*XX**XX***X
X**X*XXX*XX**XX*XXX*XXX
XX***XX*****XX***XX*XX*
XXX*XXX*XXX*X**X****X**
XX********XXX*XXXX*XX*X
***XXXXXX*****XXXX*****
*XXX******XXX******XXX*