**************
XXXXXXXXXXXXX*
XXXXXXXXXX****
XXXXXX*****XXX
X******XXX****
X**XXXXXXXXX**
X*XXXX*******X
X***XXXXXXXXXX
XXX******XXXXX
XX**XXXX******