############################
#............##............#
#*####.#####.##.#####.####*#
#.####.#####.##.#####.####.#
#..........................#
#.####.##.########.##.####.#
#.####.##.########.##.####.#
#......##....##....##......#
######.#####.##.#####.######
     #.#####.##.#####.#     
     #.##..........##.#     
     #.##.###  ###.##.#     
######.##.#      #.##.######
..........# abcd #..........
######.##.#      #.##.######
     #.##.########.##.#     
     #.##..........##.#     
     #.##.########.##.#     
######.##.########.##.######
#............##............#
#.####.#####.##.#####.####.#
#.####.#####.##.#####.####.#
#*..##........@.......##..*#
###.##.##.########.##.##.###
###.##.##.########.##.##.###
#......##....##....##......#
#.##########.##.##########.#
#.##########.##.##########.#
#..........................#
############################