############################
#......##..........##......#
#*####.##.########.##.####*#
#.####.##.########.##.####.#
#..........................#
###.##.#####.##.#####.##.###
###.##.#####.##.#####.##.###
....##.......##.......##....
###.#####.########.#####.###
  #.#####.########.#####.#  
  #......................#  
  #.#####.###  ###.#####.#  
  #.#####.#      #.#####.#  
  #.##....# abcd #....##.#  
  #.##.##.#      #.##.##.#  
###.##.##.########.##.##.###
.......##.....@....##.......
###.########.##.########.###
  #.########.##.########.#  
  #..........##..........#  
  #.#####.########.#####.#  
###.#####.########.#####.###
#..........................#
#.####.#####.##.#####.####.#
#.####.#####.##.#####.####.#
#.####.##....##....##.####.#
#*####.##.########.##.####*#
#.####.##.########.##.####.#
#..........................#
############################