############################
.......##..........##.......
######.##.########.##.######
######.##.########.##.######
#*...........##...........*#
#.#######.##.##.##.#######.#
#.##......##.##.##......##.#
#.##.####.##....##.####.##.#
#.##.####.########.####.##.#
#......##.########.##......#
######.##..........##.######
######.##.###  ###.##.######
#......##.#      #.##......#
#.####.##.# abcd #.##.####.#
#.####....#      #....####.#
#...##.##.########.##.##...#
###.##.##..........##.##.###
  #.##.####.####.####.##.#  
  #.##.####.####.####.##.#  
  #.........####.........#  
  #.#######.####.#######.#  
###.#######.####.#######.###
.......##.....@....##.......
###.##.##.########.##.##.###
###.##.##.########.##.##.###
#*..##.......##.......##..*#
#.####.#####.##.#####.####.#
#.####.#####.##.#####.####.#
#..........................#
############################