############################
#..........................#
#..........................#
#..........................#
#..........................#
#..........................#
#..........................#
#..........................#
#..........................#
#..........................#
#..........................#
#.........###  ###.........#
#.........#      #.........#
#.........# abcd #.........#
#.........#      #.........#
#.........########.........#
#..........................#
#..........................#
#..........................#
#..........................#
#..........................#
#..........................#
#.............@............#
#..........................#
#..........................#
#..........................#
#..........................#
#..........................#
#..........................#
############################