#######
#     #
# OXQP#
#     #
#######
