#######
#     #
# O  X#
# P  Q#
#######