#####
#   #
# P #
#   #
#####
