######
#    #
# XO #
#    #
######