########
#      #
# XOXP #
#      #
########