########
#      #
# QOXPP#
#      #
########