################
#              #
# # ######     #
# #  X X X X#  #
# #   XQX   ## ##
# # #X X X###OOO#
# #   X X  ##OOO#
# ###XXX X ##OOO#
#     # ## ##OOO#
#####   ## ##OOO#
    ##### P   ###
        #     #
        #######
